account,transaction type,amount,date,expected balance
wawan,0,1000000,2020-08-17,1000000
teguh,0,5000000,2020-08-18,6000000
joko,1,2000000,2020-09-30,4000000
joko,2,1000000,2020-11-10,5000000
wawan,0,5000000,2020-12-01,10000000
teguh,1,2000000,2020-12-01,8000000
